1w111
10111
10101
10001
1X111
11111
