1w111
10111
10101
10001
1x111
11111